111111111111111
111111111111111
110010000000C11
110000111110C11
11P0011E0000011
111111111111111
100000000000001
111111111111111
