11111
100P1
10001
11001
10011
101E1
10101
10101
10101
10001
1CC01
11111
